#######################
#          #          #
# ### #### # #### ### #
# ### #### # #### ### #
#                     #
# ### # ####### # ### #
#  F  #    #    #     #
##### #### # #### #####
##### #         # #####
##### # ###_### # #####
#       #  F  #    F  #
##### # ####### # #####
##### #    @    # #####
##### # ####### # #####
#  F       #          #
# ### #### # #### ### #
#   #             #   #
### # # ####### # # ###
#     #    #    #     #
# ######## # ######## #
#                     #
#######################