|----------------------------------|
|..................................|
|-----......------------......-----|
|...........................F......|
|..------------......------------..|
|.....F............................|
|-----......------------......-----|
|..................................|
|..------------......------------..|
|................@.................|
|-----......------------......-----|
|............................F.....|
|----------------------------------|