##########
#F F#  #F#
#  ##@   #
# F    # #
##########