|--------|
|F.F|..-F|
|..-|.@..|
|.F....-.|
|--------|