####################################
#                                  #
######      ###########      #######
#                          F       #
#   ###########      ###########   #
#     F                            #
######      ###########      #######
#                                  #
#   ###########      ###########   #
#                @                 #
######      ###########      #######
#                           F      #
####################################